###########################################################
#EEEEEEEEEEEEEEEEEEEEEEEEEEEEEEEEEEEEEEEEEEEEEEEEEEEEEEEEE#
#EEEEEEEEE    EE    EEEEEEEEEEEEEEEEEEE       EEEEEEEEEEEE#
#E                          EEEEEEEEEEEEEEEEEEEEEEEEEEEEEE#
#EEEEEEEEEEEEEEEEEEEEEEEEEEEEEEEEEEEEE                   E#
#E           EEE                                E        E#
#EE                     EEEEEEEEEEEEEEEEE             EEEE#
#E          E  E       E      E    E E E E E E EE  EEE  EE#
#EEE E     E    E   E   E    E      E    EEEEEEEEEEEEEEEEE#
#EEEEEEEEEEEEEEEEEEEEEEEEEEEEEEEEEEEEEEEEEEEEEEEEEEEEEEEEE#
#EEEEEEEEEEEEEEEEEEEEEEEEEEEEEEEEEEEEEEEEEEEEEEEEEEEEEEEEE#
#E                                                       E#
#E              E       E           E         E EEE EEE  E#
#EEEEEEEEEEEEEEEEEE             P                        E#
#E                   E     E                             E#
#E E      E       E     E      E      E       E          E#
#E              E EEEEEEE        E E E E    EEE EEE EE   E#
#EEEEEEEEEEEEEEEEEEEEEEEEEEEEEEEEEEEEEEEEEEEEEEEEEEEEEEEEE#
###########################################################
