######################################################################
#E EEEEEEEEEEEEEE            EEEEEEEEEEEEEEE      EEEEEE      E  E  E#
#EEEEEEE        EEEEEEE          EEEEEEE          EEE      EEEEE   EE#
#EEEEEEEEEEEEEEEEEEEEEEEEEEEEEEEEEEEEEEEEEEEEEEEEEEEEEEEEEEEEEEEEEEEE#
#   E                                                                #
#  E                 E                  EEEEEEEEEEEEEEEEEEEEEEEEEEEEE#
# E              P        E                       EEEEEEEEEEEEEEEEEEE#
#E                                  EEEE                             #
# E                    E      E       E                              #
#  E                                  E  EEEEEEEEEEEEEEEEEEEEEEEEEEEE#
#EEEEEEEEEEEE                                 EEEEEEEEEEEEEEEEEEEEEEE#
#                                    EEEEEEEEEEEEEEEEEEEEEEEEEEEEEEEE#
#          E         EEEEEEEEEEEEEEEEEEEEEEEEEEEEEEEEEEEEEEEEEEEEEEEE#
#EEEEEE     E           EEEEEEEEEEEEEEEEEEEEEEEEEEEEEEEEEEEEEEEEEEEEE#
#EE         E     E      EEEEEEEEEEEEEEEEEEEEEEEEEEEEEEEEEEEEEEEEEEEE#
#                           EEEEEEEEEEEEEEEEEEEEEEEEEEEEEEEEEEEEEEEEE#
#EEEEEE                          EEEEEEEEEEEEEEEEEEEEEEEEEEEEEEEEEEEE#
#EE               E       EE     EEEEEEEEEEEEEEEEEEEEEEEEEEEEEEEEEEEE#
#                           E    EEEE               EEEEEEEEEEEEEEEE #
#                                EEEE                                #
# EEEE E   EEEEEEEE   EEE E E    EEEE    EEEEEEEEEEE      EEEEEEEEEEE#
#E     E E           E EE        EEEE       EEEEEE        EEEEEE  EE #
#       E                   E    EEEE                       EEE  EE  #
#      E E   E      E       E    EEEE                                #
#         E                    EEEEEEEE                              #
#      E     E              EEEEEEEEEEEEEEEE                         #
#                     EEEEEEEEEEEEEEEEEEEEEEEEEEE                    #
#           EEEEEEEEEEEEEEEEEEEEEEEEEEEEEEEEEEEEEEEEEEEEEE           #
#EEEEEEEEEEEEEEEEEEEEEEEEEEEEEEEEEEEEEEEEEEEEEEEEEEEEEEEEEEEEEEEEEEEE#
######################################################################
